1111111111110111111111111
1000000001000001000000001
1011010101011101010101101
1000010000000000000100001
1110110111011101110110111
1000000001000001000000001
1011010101011101010101101
1000010000011100000100001
1110110111011101110110111
1000000001000001000000001
1011010101011101010101101
1000010000000000000100001
1110110111011101110110111
1000000001000001000000001
1011010101011101010101101
1000010000000000000100001
1111111111110111111111111