111111111111111111111111111111
100000000000000000000001100001
101011110111111101110100000101
100010000000000000000101110001
111010110111011101110101110111
000010010111011100000101110000
111011110111011101110101000111
100000000000000000100001110001
101101111010111010101000000101
100000000010000010001001110001
111111111111111111111111111111