1111111111111111111111111111111111111111
1111111111111111111111111111111111111111
1111111111111111111111111111111111111111
1111111111111111111111111111111111111111
1111111111111111111111111111100111111111
1111111111111111111111111111100111111111
1111111111111111111111111111100111111111
1111100001000110111100100001100000111111
1111000000010010011000001100000010011111
1111001100111000011001011110100111001111
1111001100111011001011011110100111001111
1111001100111011000011011100100111001111
1111001100111011100011000000100010011111
1111011110111011100111100011101100111111
1111111111111111100111111111111111111111
1111111111111111001111111111111111111111
1111111111111111011111111111111111111111
1111111111111111111111111111111111111111
1111111111111111111111111111111111111111
1111111111111111111111111111111111111111
1111111111111111111111111111111111111111